apple: a fruit
ant: a small insect typically having a sting and living in a complex social colony
anchor: a device used to prevent a ship or boat from drifting
astronaut: a person who is trained to travel in a spacecraft
art: the expression or application of human creative skill and imagination
avocado: a pear-shaped fruit with a rough leathery skin and smooth, oily edible flesh
arm: each of the two upper limbs of the human body from the shoulder to the hand
arrow: a shaft sharpened at the front and with feathers or vanes at the back, shot from a bow
airplane: a powered flying vehicle with fixed wings
antique: a collectible object such as a piece of furniture or work of art that has a high value because of its age and quality

butterfly: an insect with large, colorful wings and a slender body
ball: a round object used in various games and sports
banana: a long, curved fruit with a yellow skin
book: a written or printed work consisting of pages glued or sewn together along one side and bound in covers
bridge: a structure carrying a road, path, railroad, or canal across a river, ravine, road, railroad, or other obstacle
bottle: a container with a narrow neck, typically used to hold liquids
bicycle: a vehicle composed of two wheels held in a frame one behind the other, propelled by pedals
bee: an insect of a large group to which the honeybee belongs, including many solitary as well as social kinds
bread: food made of flour, water, and yeast or another leavening agent, mixed together and baked
boat: a small vessel for traveling over wate

cat: a small domesticated carnivorous mammal with soft fur
car: a road vehicle, typically with four wheels, powered by an internal combustion engine
cake: a sweet baked dessert usually made from flour, sugar, and other ingredients
camera: a device for recording visual images in the form of photographs, film, or video signals
candle: a cylinder or block of wax or tallow with a central wick that is lit to produce light as it burns
chair: a separate seat for one person, typically with a back and four legs
clock: a mechanical or electrical device for measuring time
cloud: a visible mass of condensed water vapor floating in the atmosphere
computer: an electronic device for storing and processing data
cow: a fully grown female animal of a domesticated breed of ox, kept to produce milk or beef

dog: a domesticated carnivorous mammal that typically has a long snout and an acute sense of smell
dolphin: a small gregarious toothed whale with a beaklike snout
drum: a percussion instrument sounded by being struck with sticks or hands
door: a hinged, sliding, or revolving barrier at the entrance to a building, room, or vehicle
duck: a waterbird with a broad blunt bill, short legs, webbed feet, and a waddling gait
diamond: a precious stone consisting of a clear and typically colorless crystalline form of pure carbon, the hardest naturally occurring substance
desk: a piece of furniture with a flat top and one or more legs, providing a level surface for working at
dragon: a mythical monster like a giant reptile
daisy: a small grassland plant that has flowers with a yellow disk and white rays
doll: a small model of a human figure, typically one of a baby or girl, used as a child's toy

elephant: a large mammal with a trunk, large ears, and tusks, native to Africa and Asia
egg: an oval or round object laid by a female bird, reptile, fish, or invertebrate, usually containing a developing embryo
engine: a machine with moving parts that converts power into motion
eagle: a large bird of prey with a massive hooked bill and long broad wings
earthquake: a sudden and violent shaking of the ground, sometimes causing great destruction
elbow: the joint between the forearm and the upper arm
envelope: a flat paper container with a sealable flap, used to enclose a letter or document
ear: the organ of hearing and balance in humans and other vertebrates
eel: a snake-like fish with a slender elongated body and poorly developed fins
emerald: a precious stone consisting of a green variety of beryl

frog: a small tailless amphibian with a short body and long hind legs
fish: a limbless cold-blooded vertebrate animal with gills and fins, living wholly in water
flower: the seed-bearing part of a plant, consisting of reproductive organs typically surrounded by a brightly colored corolla and a green calyx
forest: a large area covered chiefly with trees and undergrowth
feather: any of the flat appendages growing from a birdâ€™s skin and forming its plumage
fan: a device with rotating blades that creates a current of air for cooling or ventilation
flame: the visible, gaseous part of a fire
fox: a small to medium-sized, omnivorous mammal belonging to several genera of the family Canidae
flag: a piece of cloth or similar material, typically oblong or square, attachable by one edge to a pole or rope and used as the symbol or emblem of a country or institution
fruit: the sweet and fleshy product of a tree or other plant that contains seed and can be eaten as food

giraffe: a tall African mammal with a very long neck and forelegs
goat: a hardy domesticated ruminant animal that has backward curving horns and (in the male) a beard
guitar: a stringed musical instrument played with the fingers or a plectrum
glass: a hard, brittle substance, typically transparent or translucent, made by fusing sand with soda, lime, and sometimes other ingredients and cooling rapidly
garden: a piece of ground, often near a house, used for growing flowers, fruit, or vegetables
gold: a yellow precious metal, the chemical element of atomic number 79
grape: a berry, typically green (classified as white), purple, red, or black, growing in clusters on a grapevine
globe: a spherical representation of the earth or the heavens
goose: a large waterbird with a long neck, short legs, webbed feet, and a short broad bill
game: a form of play or sport, especially a competitive one played according to rules and decided by skill, strength, or luck

hippopotamus: a large thick-skinned mammal found in African rivers and lakes
house: a building for human habitation
hat: a shaped covering for the head, typically with a brim and a crown
hammer: a tool with a heavy metal head mounted at right angles at the end of a handle, used for jobs such as breaking things and driving in nails
horse: a solid-hoofed plant-eating domesticated mammal with a flowing mane and tail, used for riding, racing, and to carry and pull loads
honey: a sweet, sticky yellowish-brown fluid made by bees and other insects from nectar collected from flowers
hill: a naturally raised area of land, not as high or craggy as a mountain
heart: the organ in your chest that pumps blood through your veins and arteries
honeybee: a stinging winged insect that collects nectar and pollen, produces wax and honey, and lives in large communities
harbor: a place on the coast where vessels may find shelter


iguana: a large, arboreal lizard native to Central and South America
ice: frozen water, a brittle, transparent crystalline solid
island: a piece of land surrounded by water
igloo: a dome-shaped Eskimo house, typically built from blocks of solid snow
insect: a small arthropod animal that has six legs and generally one or two pairs of wings
iron: a strong, hard magnetic silvery-gray metal
inch: a unit of linear measure equal to one twelfth of a foot (2.54 cm)
ivy: a woody evergreen climbing plant
ink: a colored fluid used for writing, drawing, printing, or duplicating
infant: a very young child or baby

jaguar: a large wild cat with a yellowish-brown coat and black spots, native to the Americas
jelly: a soft, elastic, and usually translucent food product
jacket: an outer garment extending either to the waist or the hips
jewel: a precious stone
jungle: an area of land overgrown with dense forest and tangled vegetation
juice: the liquid obtained from or present in fruit or vegetables
jar: a wide-mouthed, cylindrical container made of glass or pottery
jigsaw: a machine saw with a fine blade enabling it to cut curved lines in a sheet of wood, metal, or plastic
jump: to push oneself off a surface and into the air by using the muscles in one's legs and feet
jam: a sweet spread or preserve made from fruit and sugar

kangaroo: a large marsupial from Australia with powerful hind legs for jumping
kite: a toy consisting of a light frame covered with thin material, flown in the wind at the end of a long string
key: a small piece of shaped metal with incisions cut to fit the wards of a particular lock
king: the male ruler of an independent state, especially one who inherits the position by right of birth
koala: an arboreal Australian marsupial that has large ears, a very large nose, and sharp claws
kitchen: a room or area where food is prepared and cooked
kettle: a container or device in which water is boiled, having a lid, spout, and handle
kiwi: an edible berry of a woody vine
knight: a man who served his sovereign or lord as a mounted soldier in armor
knee: the joint between the thigh and the lower leg

lion: a large carnivorous feline animal, known as the king of the jungle
lamp: a device that produces light
leaf: a flattened structure of a higher plant, typically green and bladelike, that is attached to a stem directly or via a stalk
lemon: a yellow, oval citrus fruit with thick skin and fragrant, acidic juice
lighthouse: a tower or other structure containing a beacon light to warn or guide ships at sea
lake: a large body of water surrounded by land
ladder: a structure consisting of a series of bars or steps between two upright lengths of wood, metal, or rope, used for climbing up or down something
lock: a device used to secure a door, gate, or lid
lobster: a large marine crustacean with a cylindrical body, stalked eyes, and the first of its five pairs of limbs modified as pincers
laptop: a computer that is portable and suitable for use while traveling

monkey: a small to medium-sized primate that typically has a long tail
mountain: a large natural elevation of the earth's surface rising abruptly from the surrounding level
moon: the natural satellite of the earth, visible (chiefly at night) by reflected light from the sun
mango: a tropical fruit with smooth yellow or red skin, soft orange flesh, and a large seed inside
mouse: a small rodent that typically has a pointed snout, relatively large ears and eyes, and a long tail
motorcycle: a two-wheeled vehicle that is powered by a motor and has no pedals
map: a diagrammatic representation of an area of land or sea showing physical features, cities, roads, etc.
magnet: a piece of iron or other material that attracts iron and some other materials
microscope: an optical instrument used for viewing very small objects
mushroom: a fungal growth that typically takes the form of a domed cap on a stalk

narwhal: a medium-sized toothed whale that possesses a large "tusk" from a protruding canine tooth
notebook: a small book with blank or ruled pages for writing notes in
nest: a structure or place made or chosen by a bird for laying eggs and sheltering its young
necklace: an ornamental chain or string of beads, jewels, or links worn around the neck
needle: a very fine, slender piece of polished metal used in sewing
nurse: a person trained to care for the sick or infirm, especially in a hospital
night: the period of darkness in each twenty-four hours
novel: a fictitious prose narrative of book length
net: a piece of open-meshed material made of twine, cord, or something similar
noodle: a strip, ring, or tube of pasta or a similar dough, typically made with egg and usually eaten with a sauce or in a soup

octopus: a cephalopod mollusk with eight sucker-bearing arms
owl: a nocturnal bird of prey with large forward-facing eyes surrounded by facial disks
orange: a large round juicy citrus fruit with a tough bright reddish-yellow rind
ocean: a very large expanse of sea
ostrich: a large flightless fast-running African bird with two-toed feet
oven: an enclosed compartment, as in a kitchen range, for cooking and heating food
orchid: a plant with complex flowers that are typically showy or bizarrely shaped
otter: a semiaquatic fish-eating mammal of the weasel family
onion: an edible bulb with a pungent taste and smell
ostrich: a large flightless fast-running African bird with two-toed feet

penguin: a flightless seabird with black and white plumage, native to the Southern Hemisphere
piano: a large keyboard musical instrument
peacock: a large bird, the male of which has very long tail feathers that have eye-like markings and can be erected and fanned out in display
pineapple: a large juicy tropical fruit consisting of aromatic edible yellow flesh
pencil: an instrument for writing or drawing
parrot: a bird, often vividly colored, with a short downcurved hooked bill, grasping feet, and a raucous voice
pumpkin: a large rounded orange-yellow fruit with a thick rind
panda: a large bearlike mammal with characteristic black-and-white markings
pearl: a hard, lustrous spherical mass, typically white or bluish-gray, formed within the shell of a pearl oyster
peach: a round stone fruit with juicy yellow flesh and downy pinkish-yellow skin

quail: a small, ground-dwelling game bird
queen: the female ruler of an independent state, especially one who inherits the position by right of birth
quartz: a hard, crystalline mineral composed of silicon and oxygen atoms
quill: a pen made from a main wing or tail feather of a large bird
quilt: a warm bed covering made of padding enclosed between layers of fabric and kept in place by lines of stitching
question: a sentence worded or expressed so as to elicit information
queue: a line or sequence of people or vehicles awaiting their turn to be attended to or to proceed
quasar: a massive and extremely remote celestial object, emitting exceptionally large amounts of energy
quadrant: each of four quarters of a circle
quiver: a container for holding arrows

rabbit: a small mammal with long ears, soft fur, and a short tail
rain: moisture condensed from the atmosphere that falls visibly in separate drops
rainbow: an arch of colors formed in the sky in certain circumstances
river: a large natural stream of water flowing in a channel to the sea, a lake, or another river
robot: a machine capable of carrying out a complex series of actions automatically
rose: a prickly bush or shrub that typically bears red, pink, yellow, or white fragrant flowers
ring: a small circular band, typically of precious metal or set with one or more gemstones
road: a wide way leading from one place to another
radio: the transmission and reception of electromagnetic waves of radio frequency, especially those carrying sound messages
rope: a length of strong cord made by twisting together strands of natural fibers

snake: a long, legless, carnivorous reptile
sun: the star around which the earth orbits
star: a fixed luminous point in the night sky
sand: a loose granular substance resulting from the erosion of siliceous and other rocks
ship: a large boat for transporting people or goods by sea
shell: the hard protective outer case of a mollusk or crustacean
squirrel: a small rodent with a bushy tail
spoon: an implement consisting of a small, shallow bowl on a long handle
stone: a hard, solid nonmetallic mineral matter
snow: atmospheric water vapor frozen into ice crystals

tiger: a large carnivorous feline with a striped coat, native to Asia
tree: a woody perennial plant, typically having a single stem or trunk growing to a considerable height and bearing lateral branches
table: a piece of furniture with a flat top and one or more legs
train: a series of connected railroad cars pulled or pushed by one or more locomotives
turtle: a slow-moving reptile with a shell
telephone: a system for transmitting voices over a distance using wire or radio
tomato: a glossy red, or occasionally yellow, pulpy edible fruit
trumpet: a brass musical instrument with a flared bell
tooth: each of a set of hard, bony enamel-coated structures in the jaws
towel: a piece of thick absorbent cloth or paper used for drying oneself

umbrella: a device consisting of a circular canopy of cloth on a folding metal frame supported by a central rod, used as protection against rain or sun
unicorn: a mythical animal typically represented as a horse with a single straight horn
uniform: the distinctive clothing worn by members of the same organization
utensil: a tool, container, or other article, especially for household use
utopia: an imagined place or state of things in which everything is perfect
universe: all existing matter and space considered as a whole
urge: a strong desire or impulse
upstairs: on or to an upper floor of a building
undertake: commit oneself to and begin (an enterprise or responsibility)
ulcer: an open sore on an external or internal surface of the body

vulture: a large bird of prey with a head and neck more or less bare of feathers, feeding chiefly on carrion
vase: an open container, typically used for displaying flowers
violin: a string instrument played with a bow
volcano: a mountain or hill having a crater or vent through which lava, rock fragments, hot vapor, and gas are being or have been erupted from the earth's crust
village: a group of houses and associated buildings, larger than a hamlet and smaller than a town
vegetable: a plant or part of a plant used as food
vacuum: a space entirely devoid of matter
van: a medium to large motor vehicle with a boxy shape and high roof
valley: a low area of land between hills or mountains, typically with a river or stream flowing through it
vine: a climbing or trailing woody-stemmed plant

wolf: a wild carnivorous mammal which is the largest member of the dog family
whale: a very large marine mammal with a streamlined hairless body, a horizontal tail fin, and a blowhole on top of the head for breathing
wind: the perceptible natural movement of the air
water: a colorless, transparent, odorless liquid that forms the seas, lakes, rivers, and rain
wheel: a circular object that revolves on an axle and forms part of a machine
window: an opening in the wall or roof of a building or vehicle that is fitted with glass
wrench: a tool used for gripping and turning nuts, bolts, pipes, etc.
wombat: a burrowing plant-eating Australian marsupial which resembles a small bear with short legs
whisk: a utensil for whipping eggs or cream
wire: a thin, flexible thread of metal

xylophone: a musical instrument in the percussion family that consists of wooden bars struck by mallets
x-ray: a form of electromagnetic radiation that can pass through solid objects
xenon: a chemical element, a noble gas
xylem: the vascular tissue in plants that conducts water and dissolved nutrients
xenophobia: dislike of or prejudice against people from other countries
xylophone: a musical instrument in the percussion family
xerox: a brand name for a copy machine
xenolith: a piece of rock trapped in another type of rock
xanadu: an idealized place of great or idyllic magnificence and beauty
xeroderma: a condition characterized by rough, dry skin

yak: a large domesticated wild ox with shaggy hair, native to the Himalayas
yarn: spun thread used for knitting, weaving, or sewing
yawn: involuntarily open one's mouth wide and inhale deeply due to tiredness or boredom
yellow: the color between green and orange in the spectrum
yacht: a medium-sized sailboat equipped for cruising or racing
yogurt: a semi-solid sourish food prepared from milk fermented by added bacteria
year: the time taken by the earth to make one revolution around the sun
yolk: the yellow internal part of a bird's egg
yard: a unit of linear measure equal to 3 feet (0.9144 meter)
yeast: a microscopic fungus consisting of single oval cells that reproduce by budding

zebra: an African wild horse with black-and-white stripes
zoo: an establishment which maintains a collection of wild animals
zucchini: a green variety of smooth-skinned summer squash
zipper: a fastener used to close a bag or article of clothing
zone: an area or stretch of land having a particular characteristic
zombie: a fictional undead being created through the reanimation of a human corpse
zigzag: a line or course having abrupt alternate right and left turns
zephyr: a gentle, mild breeze
zenith: the time at which something is most powerful or successful
zeppelin: a large German dirigible airship
